#############################################################################################
#          ~~~~~~~~~~~~~~~~~~~~~~~~~~~~~~~                        ^^^^^^                    #
#           ~~~~~~~~~~~~~~~~~~~~~~~~~~~~~            ^^^            ^^^^^^          ^^^     #
#            ~~~~~~~~~~~~~~~~~~~~~~~~~~~               ^^^                            ^^^   #
#     ^^^     ~~~~~~~~~~~~~~~~~~~~~~~~~                                                     #
#       ^^^    ~~~~~~~~~~~~~~~~~~~~~~~                                                      #
#               ~~~~~~~~~~~~~~~~~~~~~                                        ^^^^^^         #
#                 ~~~~~~~~~~~~~~~~~~                                            ^^^^^^      #
#                  ~~~~~~~~~~~~~~~~                  ^^^^^^                                 #
#                   ~~~~~~~~~~~~~~                      ^^^^^^                              #
#      ^^^           ~~~~~~~~~~~~                                                           #
#        ^^^          ~~~~~~~~~~                                                            #
#                      ~~~~~~~~          ~~                                                 #
#                       ~~~~~~          ~~~~                                               ~#
#                        ~~~~          ~~~~~~~                ^^^^^^                      ~~#
#     ^^^                 ~~          ~~~~~~~~~                  ^^^^^^                 ~~~~#
#       ^^^                          ~~~~~~~~~~~                                      ~~~~~~#
#                                   ~~~~~~~~~~~~~                                   ~~~~~~~~#
#                 ^^^              ~~~~~~~~~~~~~~~~        ^^^                   ~~~~~ ^oo^ #
#                   ^^^           ~~~~~~~~~~~~~~~~~~         ^^^               ~~~~~~~ (..) #
#                                ~~~~~~~~~~~~~~~~~~~~                        ~~~~~~~~~()  ()# 
#                               ~~~~~~~~~~~~~~~~~~~~~~                                ()__()# 
#############################################################################################
