#############################################################################################
#          ^^^^^^^^^^^^^^^^^^^^          ~~~~~~                                   ~~~~      #
#           ^^^^^^^^^^^^^^^^^^          ~~   ~    ~~~~~~     ~~   ~~               ~~~~    ^#
#            ^^^^^^^^^^^^^^^^                    ~~   ~~                                  ^^#
#             ^^^^^^^^^^^^^^                                                             ^^^#
#              ^^^^^^^^^^^^   ~~~~~                                 ~~~~~~              ^^^^#
#               ^^^^^^^^^^                                         ~~   ~~               ^^^#
#                ^^^^^^^^                       ~~   ~~                                   ^^#
#                 ^^^^^^                          ~~~~~~                                   ^#
#                  ^^^^     ~~~~~~                                                          #
#~~                 ^^                                                                      #
# ~~   ~~                           ~~   ~~               ^                 ~~   ~~         #
#   ~~~  ~~~~                        ~~~~~~                      ^^                         #
#                                                               ^^^^                        #
#                                                              ^^^^^^                       #
#                                             ~~   ~~         ^^^^^^^^    ~~~  ~~~~         #
#                                              ~~~~~~        ^^^^^^^^^^                     #
#         ~~   ~~             ~~   ~~                       ^^^^^^^^^^^^                    #
#          ~~~~~~              ~~~~~~     ~~~  ~~~~        ^^^^^^^^^^^^^^                   #
#                                        ~~~  ~~~~        ^^^^^^^^^^^^^^^^                  #
#                      ~~   ~~                           ^^^^^^^^^^^^^^^^^^   ~~~  ~~~~     #
#                                                       ^^^^^^^^^^^^^^^^^^^^              < #
#############################################################################################